32	32
..........@......@...@.@........
@...@.@@...........@.@...@......
..............@........@@...@...
.....@.@..........@..........@..
.@@...........@@.@......@..@....
......@..@.@..@@......@....@..@@
......@..@@........@.......@...@
.@...@...............@@...@..@..
......@.........@.......@.@.....
..@.@............@.@.......@@...
@.@.........@.@.......@...@.....
............@.....@.@.@.......@.
..@.....@.@.@@.@..........@.....
.@................@.@.....@...@.
...@@@.......@.........@........
........@....@.@.@..@...........
..@...@........@....@..@@@....@.
.@......@@@..@.@..@.@..@@....@T@
@.........@........@..@......@@@
......@...@..@..@.@...@...@.....
.@.@........@.........@@.@...@..
.......@@@........@..@@@..@@@...
..@@@@@@..@@@......@..........@.
.......@....@@....@...@.@.@@....
...........@.....@...@.@..@.@...
...........@....@........@..@..@
@@......@.@@........@@.........@
..@..@..@..@....................
@..@@......@...@...@.........@@@
@....@....@....@.@.@...@......@@
@@....@@@@.@@.....@........@....
@@.............@..@.........@...
30	3	29	6