64	64
.@...@.@........................@...@.....@...@.................
.......@.............@...@.........@.........@....@.............
......................@.........@.....................@....@....
..@.@..@...........................@@.............@.@.....@....@
......@..@.........@........@...................................
.....@.@........@@............@...@..@......@.........@.....@...
............@........@.....@..................@...@...@@......@.
..@..........................@..........@........@..............
......@.@..............@...........@....................@...@...
@@................@....@..........................@....@.......@
.....@.................@....................@....@.......@@.....
.@...........................@.............@..............@.....
.@..@.....@.................@.....@@..........................@.
.........@@......@.@.............@..........@................@..
....@....@..............@..@............@..@...@..........@.....
....@............@...........@.@...@........@.....@.............
..............................................@..@..............
..@.......@...@...............................@..........@......
......................@.@......@.....@@.......@...@.@...........
@......@..........@....@..........................@@@@@....@....
@.@..........@......@..@............@..@.......@.....@........@.
....@.....@...@..@...........@.@@@..........@@..@........@......
...............@.....@@....................@...............@....
..@.@..@@@.@.....@..............@...@.........@.................
..........@......@..............@........@.......@...@..........
..................@..................................@.@.....@..
@....@...@@...@..........@....................@.................
........@.......@.@....................................@...@.@.@
@................@.........@......@..@..............@...........
....@..@..@@............@........................@..............
..................................@..@...........@...........@..
........@..........@.........@........@.....@..............@.@..
................@...........@..............@........@........@..
...@...@...........@.......@.....................@..............
.....@.............@...................@.@................@.....
...@.....@..........@@..........@..........................@....
....@...@..............@..............@.@............@.......@..
.......@....................................@.............@.....
.................@@.....@....@................@.................
.....@..@..........@....@....@@.........@..@....@..@.........@..
..@.......@.@......@..........@.@@....................@....@....
..............@...........................@....@................
.....@...........@.............@....@........................@..
....@......@........@........@......@..........@.....@.@........
..@@....@..........@..@...............@.................@..@....
..................@.........@@.....@.................@......@...
...................@.........@...@.........@........@......@....
..@...@.....@......................................@........@...
@..............@............................@.....@...@@........
............................@............@..@......@............
.............................@.@@..........@....@......@..@.....
.....@.....@................@@@.@......................@..@@....
...@.@...@.........@............@...................@...........
....@..................@.......@@.......@..@..........@....@.@..
.....................@@...@..@...............@.......@..@......@
...................@......@......@............@................@
.......@..@..@.@..@.@..@@..@....@@..........@...................
..................@...........................@@@...@...........
...........................@....@.........@.....................
........@..........@......@........@............................
...............................@..................@.@...........
........................@....................@.......@........@.
..@..........................@..@...@.....@.@.........@.........
@@.........@@@.............@....@..................@........@.@@
0	55	57	15