32	32
..........@......@...@.@........
@...@.@@...........@.@...@......
..............@........@@...@...
.....@.@..........@..........@..
.@@...........@@.@......@..@....
......@..@.@..@@......@....@..@@
......@..@@........@.......@...@
.@...@...............@@...@.....
......@.........@.......@.@.....
..@.@............@.@........@...
@.@.........@.@.......@...@.....
............@.....@.@.@.@.....@.
..@.....@.@.@@.@..........@.....
.@................@.@.....@...@.
...@@@.......@@@....@..@........
........@....@.@.@..@...........
..@...@........@....@..@@@....@.
.@......@@@..@@@..@.@..@@....@T@
@.........@........@..@......@@@
......@...@.@@..@.@...@...@.....
.@.@........@.........@@.@...@..
.......@.@........@..@@@..@@@...
..@.@..@....@......@..........@.
.......@.....@....@...@.@.@@....
.................@...@.@..@.@...
................@........@..@..@
.@......@.@.........@@.........@
..@..@..@.......................
@..@@......@...@...@.........@@@
@....@....@....@.@.@...@......@@
@@.@..@@.@.@@.....@........@....
@@.............@..@.........@...
20	9	6	29