32	32
..........@......@...@.@........
@...@.@@...........@.@...@......
..............@........@@...@...
.....@.@..........@..........@..
.@@...........@@.@......@..@....
......@..@.@..@@......@....@..@@
......@..@@........@.......@...@
.@...@...............@@...@..@..
......@.........@.......@.@.....
..@.@....@.......@.@.......@@...
@.@......@..@.@.......@...@.....
.........@..@.....@.@.@.......@.
..@.....@@@.@@.@..........@.....
.@................@.@.....@...@.
...@@@.......@.........@........
........@....@.@.@..@...........
..@...@........@....@..@@@....@.
.@......@@@@@@.@..@.@..@@....@T@
@.........@........@..@......@@@
......@...@..@..@.@...@...@.....
.@.@........@.........@@.@...@..
.......@.@........@..@@@..@@@...
..@.@..@....@......@..........@.
.......@.....@....@...@.@.@@....
.................@...@.@..@.@...
................@@@......@..@..@
.@......@.@........@@@.........@
..@..@..@.......................
@..@@......@...@...@.........@@@
@....@....@....@.@.@...@......@@
@@.@..@@.@.@@.....@........@....
@@.............@..@.........@...
30	21	9	7