32	32
..........@......@...@.@........
@...@.@@...........@.@...@......
..............@........@@...@...
.....@.@..........@..........@..
.@@...........@@.@......@..@....
.@....@..@.@..@@......@....@..@@
.@....@..@@........@.......@...@
.@...@...............@@...@..@..
........................@.@.....
..@.@............@@@@@@....@@...
@.@.........@.@.......@...@.....
............@.....@.@.@...@...@.
..@.....@.@.@@.@..........@.....
.@................@.@.....@...@.
...@@@.......@.........@........
........@....@.@.@..@...........
..@...@........@....@..@@@....@.
.@......@@@..@.@..@.@..@@....@T@
@.........@........@..@......@@@
......@...@..@..@.@...@...@.....
.@.@........@.........@@.@...@..
.......@.@........@..@@@..@@@...
..@.@..@....@......@..........@.
.......@.....@....@...@.@.@@....
.................@...@.@..@.@...
................@........@..@..@
.@......@.@.........@@.........@
..@..@..@.......................
@..@@......@...@...@.........@@@
@....@....@....@.@.@...@......@@
@@.@..@@.@.@@.....@........@....
@@.............@..@.........@...
4	0	13	29